111111111111111111
1P000000C000000001
101111011101111101
100000010000000001
101110111111011101
100010000C00001001
111011101110111101
1C0001000001000001
101110111011101101
100000000000000C01
101011101110111101
100010000000010001
1000E000C000000001
111111111111111111