1111111111111111111111111111111111
100000000000000C00000C000000000001
101001010010000010100100P000010101
1010010010101010001001000000011111
100000000C000C0000000C000000000E01
1111111111111111111111111111111111
