111111111111111111111111
10101000000C000100000001
1011100C000C000E00000001
100C010C010C00C000000001
100C0000100C010000000001
100C0000100C000010000001
100C0000100C000100000001
100C0000C00C001000000001
1P10C0000000C00001000001
111111111111111111111111