111111
1010E1
101P11
1C00C1
111111