111111
1000E1
101P11
1C00C1
111111 