1111111111111111111111111
1W00000001C000W0011111CW1
11111P1111011111010001001
1000000100C00000010111001
1011101111110111000100001
1000100000E00010001100101
11101110111011110C0000101
1000010000C10000011011101
1011101110111011010010101
1000W0C0000000W0010010101
1110111011101101110110101
100010C000CW0100100W00101
1111111111111111111111111
