1111111111111111111111111
100C0P0001C00000011111C01
1111101111011111010001001
1000000100C00000010111001
1011101111110111000100001
1000100000E00010001100101
11101110111011110C0000101
1000010000C10000011011101
1011101110111011010010101
100000C000000000010010101
1110111011101101110110101
100010C000C00100100000101
1111111111111111111111111
