1111111111111111111111111
10000000C1000000011111001
1111101111P111110100C1001
1000000100000000010111001
1011101111110111000100001
100010000C000010001100101
1110111011101111000000101
1C00010000010000011011101
1011101110111011010010101
100000000000000C010010101
1110111011101101110110101
1CE0100000000100100000101
1111111111111111111111111