1111111111111111111111111
1P000000C0000000000000001
1111110111011111000000001
1000000100000000000111001
1011101111110111000100001
100010000C000010001100101
1110111011101111000000101
1C00010000010000011111101
1011101110111011000010101
100000000000000C000010101
1010111011101111000000101
1000100000000111100011101
10E00000C0000000C00000001
1111111111111111111111111