111111111111111111111111
100000000P00000C00000C01
101001010010000010100101
101001001010101000111111
100E00000C000C0000000C01
111111111111111111111111