1111111
1PCWCE1
1000001
1111111
